Id: 18
Name: 18
Time: 60
Difficulty: Hard
Box count: 12
Width: 15
Height: 10
Level map:
##############.
#            #.
# $  *  #*  $##
#    $P$   #* #
#  $ *#   * $ #
#   $*#*   *$ #
##$**$# #*$$* #
.#           ##
.###  ###  ###.
...####.####...
