Id: 3
Name: 3
Time: 10
Difficulty: Easy
Box count: 1
Width: 12
Height: 12
Level map:
.####.......
.#  #####...
##      ##..
# $ #    ##.
#   ##   *#.
### #   # #.
.#      # #.
.#  # ### ##
.#    P##  #
.###       #
...##   #  #
....########
