Id: 2
Name: 2
Time: 2
Difficulty: Easy
Box count: 1
Width: 12
Height: 11
Level map:
..####......
..#  #......
###  #......
#    #####..
#    #   ###
###  #   $ #
.##      P #
.#  #    *##
.#  ####  #.
.#  #..####.
.####.......
